111111111111111111111
131333333213323333131
133211121333111211231
111113331312333322131
133333133121111111131
121113111233333313131
133313333121121213331
131311111212313321111
131333133331312112131
131213131133333333131
111111111111111111111