111111111111111111111
133133331323113333331
131121133313333121131
131333121111111121331
122313132313333332311
131312331313111121321
131323131312333331211
131113131333121213331
133233131111211213131
131213132333333332131
111111111111111111111