111111111111111111111
133133333313333333331
131331131333131131131
131333133131331333311
133313331333133313331
131313133313331313131
133313331333133313331
113333133131331333131
131131131333131133131
133333333313333331331
111111111111111111111