111111111111111111111
133333333333333333331
131313131313131313131
133333333333333333331
131313131313131313131
133333333333333333331
131313131313131313131
133333333333333333331
131313131313131313131
133333333333333333331
111111111111111111111