111111111111111111111
131313131333131313131
133333333333333333331
113131313131313131311
133333333333333333331
131313131313131313131
133333333333333333331
113131313131313131311
133333333333333333331
131313131313131313131
111111111111111111111